....................
....................
..........#.........
..........#.........
..........#.........
...#......#.........
...#................
...#................
...#................
...#.....###........
....................
.........$..........
....................
.....#..............
.....#..............
.....#..............
.....#..............
.....##....#####....
...............#....
....................